$$$ exec p2 : [./filler]
Plateau 15 17:
    01234567890123456
000 ..............X..
001 .................
002 .................
003 .................
004 .................
005 .................
006 .................
007 .................
008 .oo..............
009 .................
010 .................
011 .................
012 .................
013 .................
014 .................
Piece 2 3:
*..
*..